SO ./assets/textures/brick_wall03.xpm
NO ./assets/textures/brick_wall01.xpm
WE ./assets/textures/brick_wall03.xpm
EA ./assets/textures/brick_wall01.xpm

F 76,115,76
C 133,187,101

1111111111111111111111111
1000000000110000000000001
1011000001110000000000001
10010000000000000000000011111
11111111101100000111000000001
1000000E001100000111011111111
11110111111111011100000010001
11110111111111011101010010001
11000000110101011100000000001
10000000000000000000000010001
10000000000000001101010010001
11000001110101011101011010011
11110111 1110101 101111010001
11111111 1111111 111111111111
