SO ./assets/textures/mossy.xpm
NO ./assets/textures/mossy.xpm
WE ./assets/textures/mossy.xpm
EA ./assets/textures/mossy.xpm

F 220,100,0
C 225,30,0

1111

1000N1
1111

